1111111
1000001
1010101
100C0E1
1010001
100P001
1111111